activity=活动
admin=后台管理
advertorial=推文
album=相册
api=接口
app=APP应用
article=文章
attribute=属性
bank=银行
bargain=砍价
bill=结算
brand=品牌
cart=购物车
category=分类
chain=门店
channel=频道
clerk=店员
complain=投诉
contract=消费者保障
coupon=平台卷
distribution=分销
favorites=收藏
freight=运费模板
goods=商品
health=健康
im=客服消息
level=三级分销
member=会员
menu=菜单
message=消息
orders=订单
points=积分
predeposit=美豆
refund=退款
search=搜索
seller=商家
sms=短信
spec=模板
stat=统计
store=店铺商家
svip=超级会员
sys=系统
theme=商城活动
trys=试用
virtual=虚拟
voucher=店铺卷
warden=区长
weikedao=威客道
weixin=微信公众号
yimeiduo=一美多
